[levels]
Version=101
NumberPresent=8

% 0=blank
% 1=wall
% 2=ladder
% 3=egg
% 4=grain
% 5=invisible platform
% 6=solid ladder

% size must be 20x27

% swan coords are measured in squares, origin bottom-left = 1,1
% 0 indicates swan not present
% note swans 1-4 are always present,
% swans 5-8 only appear level 25+

% elevator position must be 0-20, with
% 0=not present

% player start X,Y are measured in BBC pixels, origin bottom-left

% nb. The first line 'Chuckie Egg level data' is required.

[1]
00000000000000000000
00000000000000000000
00000000000000000000
00000000000000000000
00000002000000000000
00000032040003400003
00000112110111111011
00000002000000000000
00000002000000000000
00000002003400000000
00003002011100000000
00011112000000004000
00000002000000011000
00000002000001100000
00020002003110000000
00320402011000040300
00121112100000111110
00020002000000000000
00020002000000000000
00020002000200002000
03020402000203402030
01111112111211112110
00000002000200002000
00000002000200002000
00000002000200002000
00403002000204002000
11111111111111111111

Elevator=0
Swan1=06,17
Swan2=09,22
Swan3=0
Swan4=0
Swan5=05,12
Swan6=07,07
Swan7=13,02
Swan8=0
StartX=70
StartY=200

[2]
00000000000000000000
00000000000000000000
00000000000000000000
00000000000000000000
00002000020000000200
00002003020040030203
00002111121011111211
00002000020000000200
00002000020000000200
00202020020002000200
40202023024002000200
11211121121012111111
00200020020002000000
00200020020002000000
00200020020002000200
30200023020002000203
11210121111111101211
00200020000000000200
00200020000000000200
00200020020000000200
30203020020003004200
11211110121011101211
00200000020000000200
00200000020000000200
00200000020000000200
40240300020030040200
11110111111111111111

Elevator=0
Swan1=02,02
Swan2=19,12
Swan3=07,22
Swan4=0
Swan5=12,12
Swan6=14,22
Swan7=0
Swan8=0
StartX=70
StartY=200

[3]
00000000000000000000
00000000000000000000
00000000000000000000
00000000000000000000
00000000000002000000
00000000000002000000
00020000202002110043
00023004202002001011
00021001212142000000
00020000202011040003
00020000202000010302
43020000202000000102
11120000202000000012
00020000202000000002
00020000202004030002
02020000202011010002
02423000202000000002
12111000202000000011
02000000202000030100
02000000202000010000
02000004232000100020
02000001111010003020
02000000000000011120
02000000000000000020
02003000000000000020
02411000000004030020
11100001110111111111

Elevator=6
Swan1=18,06
Swan2=03,16
Swan3=10,20
Swan4=0
Swan5=02,02
Swan6=09,07
Swan7=0
Swan8=0
StartX=60
StartY=200

[4]

00000000000000000000
00000000000000000000
00000000000000000000
00000000000000003000
00000000200000200002
00000000240004200002
00000101211001213112
00001000200000200002
00010000200000200002
30100000200000200002
10000000230000200002
00000000211001201312
00000401200000200000
00000100200000200000
30010000200000200000
11000000200003200000
00000001200001111003
00000000200000000011
00000000200000000000
00020000200000020000
40020003200000023000
11121001211001121100
00020000200000020001
00020000200000020000
00020000200000020000
30020000204003020040
11111011111001111111

Elevator=12
Swan1=05,02
Swan2=11,22
Swan3=19,22
Swan4=18,02
Swan5=11,07
Swan6=0
Swan7=0
Swan8=0
StartX=70
StartY=200

[5]

00000000000000000000
00000000000000000000
00000000000000000000
00000000000020000000
00002000000023040000
00042344000021110043
00012111000020000011
00002000010320000000
00002000000111000000
00202000000000100000
30202002000000000000
11212102000000000000
00202002000000000000
00202002000000000000
00202002000020000000
30202002004020040003
11111102031121110001
00000002000020000000
00000000000020000000
00020000002020200000
30020302002020200000
11121102012113210000
00020002002000200000
00020002002000200000
00020002002000200000
30024442002004240040
11011111111101110011

Elevator=17
Swan1=02,07
Swan2=04,12
Swan3=02,17
Swan4=15,12
Swan5=16,07
Swan6=0
Swan7=0
Swan8=0
StartX=60
StartY=200

[6]

00000000000000000000
00000000000000000000
00000000000000000000
00000000000000000200
00000000000000200203
00000030000000200211
00030010100030200200
00000000000011211200
00000000000000200200
00002000000000000200
40442003000000000203
11112100000000001211
00002000000000000000
00002000000000000000
00002000000000200200
00002004000030203200
00112111000011211204
00002000000000200211
00002000000000200200
20002000000000200200
20002300000030200200
21012100000011100200
20002000000000000200
20002000000000000200
20000000000000000200
20300000000444403200
11100011100111100000

Elevator=10
Swan1=02,02
Swan2=02,17
Swan3=14,07
Swan4=19,17
Swan5=19,11
Swan6=0
Swan7=0
Swan8=0
StartX=59
StartY=200

[7]

00000000000000000000
00000000000000000000
00000000000000000000
00000202020000000000
00000232323002000000
00000202020042030000
00000202020112111000
00000202020002000000
00000000000002000000
02000000000002000000
02040003000002020000
12111011000002020000
02000000000011123000
02000000000000020000
02000000000000020000
02000100100300020000
12100100101100020000
02000100000000023000
02000103400000111000
02020111100000000000
02420000000000000000
02120000000000000000
02020000000000000000
12020000000030000000
02320000010010000000
02020110010000011300
00011001100000000000

Elevator=19
Swan1=02,17
Swan2=16,10
Swan3=14,22
Swan4=0
Swan5=03,07
Swan6=03,12
Swan7=0
Swan8=0
StartX=59
StartY=200

[8]

00000000000000000000
00000000000000000000
00000000000000000000
00030000000000000300
00000000002000000000
00000000002000000000
00010313112113130100
00000000002000000000
00000000002000000000
00002000002000002000
00002000002000002000
00012110311130112100
00002000000000002000
00002000000000002000
00002000002000002000
00002000002000002000
00111130112110311110
00000000002000000000
00000000002000000000
00020000002000000200
00020000002000000200
00121301111111031210
00020000000000000200
00020000000000000200
00020000000000000200
04424440444444444244
11111111111111111111

Elevator=0
Swan1=11,12
Swan2=11,22
Swan3=18,02
Swan4=0
Swan5=05,17
Swan6=18,17
Swan7=0
Swan8=0
StartX=59
StartY=200

[end]
